#player spawn point x and y
0,20
#end level point x and y
100,100
#enemy id and its x and y - list
1:0,0;2:30,38;4:1,1
#item id and its x and y - list
0:23,248;1:358,235;
#map
000000000000000000000000000000
000000000000000000000000000000
000000000000000000000000000000
000000000000000000000000000000
000000000000000000000000000000
000000000000000000000000000000
000000000000000000000000000000
111111111111111111111111111111
210103240340504200201301042232