#player spawn point x and y
65,500
#end level point x and y
65,520
#enemy id and its x and y - list
0:350,575;0:850,575;0:300,500
#item id and its x and y - list
0:23,248;1:32,85;
#map
222222222222222222222222222222
200000000000000000000000000002
210202102010010012120212012002
200000000000000000000000000002
200000000000000000000000000002
211111111111111111111111111112
200000000000000000000000000002
211111111121111111111111111112
200000000220000200000000000002
211121112221112021111111111112
222222222222222121122222221122